##########
#  #######
# .# #####
#    $.###
#  #   ###
#.### $ ##
#  ##$  ##
#  .  $ ##
#    #@###
##########